R 1080 720
NO textures/redbrick.xpm
SO textures/mossy.xpm
WE textures/stone.xpm
EA textures/wood.xpm
S textures/dog.xpm
F 80,80,80
C 200,255,255


1111111111111111111111111111111111111111111111111111111111111111111111
1000100000000000000000000000000000000000000000000000000000000200000001
1000100000000000000000000000000000000000000000000000000000000000000001
1000100000000000000000000000000000000000000000000000000000000000000001
1000100000000000000000000000000000000000000000000000000000000000000001
100010000000S000000000000000000000000000000000000000000000000000000001
1000000000000000000000000000000000000000000000000000000000000000000001
1000000000000000000000000000000000000000000000000000000000000000000001
1100000000110000000000000000000000000000000000000000000000000000000011
1111100000000000000000000000000000000000000000000000000000000000111111
1000000000000000000000000000000000000000000000000000000000000000000011
1000001111110000000000000000000000000000000000000000000000000000000001
1000001111110000000000000000000000000000000000000000000000000000000001
1000001111110000000000000000000000000000000000000000000000000020000001
1000001111110000000000000000000000000000000000000000000000000000000001
1000001111112000000000000000000000000000000000000000000000000000000021
1000001111110000000000000000000000000000000000000000000000000000000001
1000001111110000000000000000000000000000000000000000000000000020000001
1000001111110000000000000000000000000000000000000000000000000000000001
1000001111110000000000000000000000000000000000000000000000000002000001
1000000000000000000000000000000000000000000000000000000000000000000001
1000000000000000000000000000000000000000000000000000000000000000000001
1000100000000000000000000000000000000000000000000000000000000200000001
1000100000000000000000000000000000000000000000000000000000000000000001
1000100000000000000000000000000000000000000000000000000000000000000001
1000100000000000000000000000000000000000000000000000000000000000000001
1000100000000000000000000000000000000000000000000000000000000000000001
1000000000000000000000000000000000000000000000000000000000000000000001
1000000000000000000000000000000000000000000000000000000000000000000001
1100000000110000000000000000000000000000000000000000000000000000000011
1111100000000000000000000000000000000000000000000000000000000000111111
1000000000000000000000000000000000000000000000000000000000000000000011
1000001111110000000000000000000000000000000000000000000000000000000001
1000001111110000000000000000000000000000000000000000000000000000000001
1000001111110000000000000000000000000000000000000000000000000020000001
1000001111110000000000000000000000000000000000000000000000000000000001
1000001111112000000000000000000000000000000000000000000000000000000021
1000001111110000000000000000000000000000000000000000000000000000000001
1000001111110000000000000000000000000000000000000000000000000020000001
1000001111110000000000000000000000000000000000000000000000000000000001
1000001111110000000000000000000000000000000000000000000000000002000001
1000000000000000000000000000000000000000000000000000000000000000000001
1000000000000000000000000000000000000000000000000000000000000000000001
1000100000000000000000000000000000000000000000000000000000000200000001
1000100000000000000000000000000000000000000000000000000000000000000001
1000100000000000000000000000000000000000000000000000000000000000000001
1000100000000000000000000000000000000000000000000000000000000000000001
1000100000000000000000000000000000000000000000000000000000000000000001
1000000000000000000000000000000000000000000000000000000000000000000001
1000000000000000000000000000000000000000000000000000000000000000000001
1100000000110000000000000000000000000000000000000000000000000000000011
1111100000000000000000000000000000000000000000000000000000000000111111
1000000000000000000000000000000000000000000000000000000000000000000011
1000001111110000000000000000000000000000000000000000000000000000000001
1000001111110000000000000000000000000000000000000000000000000000000001
1000001111110000000000000000000000000000000000000000000000000020000001
1000001111110000000000000000000000000000000000000000000000000000000001
1000001111112000000000000000000000000000000000000000000000000000000021
1000001111110000000000000000000000000000000000000000000000000000000001
1000001111110000000000000000000000000000000000000000000000000020000001
1000001111110000000000000000000000000000000000000000000000000000000001
1000001111110000000000000000000000000000000000000000000000000002000001
1111111111111111111111111111111111111111111111111111111111111111111111
